 :-:-:-:-:-: :-:-:-:-:-:-:-:-:-:
 |         |   |               |
 : :-:-:-: :-: :-: : : :-:-:-:-:
 |   |   |   |     | |   |     |
 : : :-: :-: : :-:-: : :-: :-: :
 | |   |     |   |   |   |   | |
 :-:-: :-:-:-:-: : : :-: :-: : :
 |   |     |     | |   |   | | |
 : :-:-: :-: : :-:-:-: : : :-: :
 |           | |       | |   | |
 : :-:-:-:-:-: : :-: :-: :-: : :
 |     |   |   |   |   |   |   |
 :-:-: : : : :-:-: :-:-:-: :-:-:
 |       | |     |     | |     |
 :-:-:-:-: :-:-: :-:-: : :-: :-:
 |     |   |   | |   | |   |   |
 : : :-: :-: : : : : : : : :-: :
 | |   |     | |   |   | | | | |
 : :-: :-:-:-: :-:-:-:-: : : : :
 |   |       |     |   | |   | |
 :-:-:-: :-: :-: :-: :-: : :-: :
 |       | | |     | |   |   | |
 :-: :-:-: : : : : : : :-:-: : :
 |   |     |   | |   |   | | | |
 : :-: :-:-:-:-:-:-:-: : : : : :
 |         |     |     | | | | |
 :-:-:-:-: : :-: : :-:-: : : : :
 |       | |   |   |   | | |   |
 : :-:-: :-: : :-:-:-: : : : :-:
 |     |     |         |   |   |
 :-:-: :-:-:-:-:-:-:-:-:-:-:-:-:
